111111111111111111111111111111
111111111111111111111110000011
111100000P000000000000000000C1
11111111C000000000000000000011
111111E00000000000000000000001
111111111111111111111111111110
